Aaron	亚伦	
Abby	艾比
Abel	亚伯
Abigail	艾比w希伯砀赣H很高d；自得的父H。	
Abigail	阿比盖尔	
Abraham	亚伯拉罕	
Ada	艾_英增光；快返模幻利。	
Adam	亚当	
Ada	艾达
Adela	鄣美德尊F的；雅的。	
Adelaide	鄣萌R德德高F的；高FA的。	
Adelaide	阿德莱德	
Adeline	艾德琳	
Adrian	艾德里安	
Afra	阿芙拉希伯m土	
Agatha	鄹鹕希D善良而美好的	
Agnes	鄹鹉萁z希D，拉丁，高雅，	
Aidan	艾登/艾丹	
Ailsa	艾丽莎	
Aimee	艾米	
Alan	艾伦
Alberta	柏塔英高F@赫的。	
Albert	艾伯特	
Alexander	亚历山大	
Alexandra	亚历桑德拉	
Alexia	莉克希希D椭	
Alexis	亚历克西斯	
Alex	亚历克斯
Alfred	阿尔弗雷德	
Alice	埯z希D尊F的，真#092;的	
Alice	爱丽丝	
Alicia	艾丽西娅	
Alina	艾琳娜	
Allison	艾莉森	
Alma	郜拉丁，英真情的、和善的、舞女。	
Althea	W瑟雅希D好A，t治者。	
Alva	阿娃拉丁白皙的。	
Alva	阿尔瓦	
Alyssa	艾莉莎/爱丽丝娅	
Amanda	阿曼_拉丁值得鄣摹	
Amanda	阿曼达	
Amber	安伯	
Amelia	阿蜜莉雅拉丁勤勉的，拥摹	
Amy	艾咪法最心鄣娜耍可鄣摹	
Amy	艾美	
Anastasia	阿娜z塔西夏希D再度振作起碇人，突睢	
Anastasia	阿纳斯塔西娅
Andrea	安德莉希D有飧牛美而雅	
Andrea	安德莉亚	
Andrew	安德鲁	
Andy	安迪
Angela	安琪拉法天使；笮耪撸安琪骸	
Angela	安吉拉	
Angelia	安吉莉亚	
Angelina	安吉莉娜	
Angel	安琪	
Angus	安格斯	
Anita	安尼塔
Ann	安妮希伯雅的，仁慈的上帝。	
Anna	安娜希伯雅	
Annabelle	安娜合２恚拉丁美的女子；可鄣模缓吞@可H的。	
Anna	安娜	
Anne	安妮
Annie	安妮
Ann	安
Anthony	安东尼	
Antonia	安|妮豪丁，希Doo以，受尊崇的人。	
Apollo	阿波罗	
April	艾V莉拉丁春天，大地初醒之r	
April	阿普里尔	
Arabela	劾肇拉拉丁，日耳曼美的祭，易於求	
Ariel	艾莉尔	
Arlene	艾琳娜特誓s、信物。	
Arnold	阿诺德	
Arthur	亚瑟	
Ashley	艾许莉/阿什利/艾希礼	
Astrid	艾z翠得丹神}的力量；星星的。	
Atalanta	特m特希D跑得快的美少女。	
Athena	雅典娜希D希D神中，聪明、及的女神，雅典的保o神。	
Audrey	W德莉法高F@赫的人。	
Audrey	欧蕊	
August	奥古斯特	
Aurora	W}拉拉丁黎明女神	
Austin	奥斯汀	
Aviva	阿维娃
Barbara	芭芭拉希D外地淼娜耍l人；族人。	
Barbara	笆笆拉	
Barbie	芭比	
Bblythe	布R英ono]的；快返摹	
Beata	贝亚特	
Beatrice	碧翠z拉丁槿似砀；蚴谷丝返呐孩	
Beatrice	比阿特丽斯
Becky	贝基
Belinda	琳_德、x大利像l蛇。有聪明又L鄣娜恕	
Bella	拉拉丁美的	
Bella	贝拉
Belle	拉法美的；上帝的誓s；明高F。	
Benjamin	本杰明	
Benson	本森	
Ben	本
Bernice	柏妮z希Dе倮息淼娜恕	
Bertha	柏莎lD明、美或N的。	
Bert	伯特	
Beryl	百合ＥDG石，幸#092;。	
Bess	z希伯砩系凼鞘募s。	
Bess	贝斯	
Betsy	琪希伯砩系凼鞘募s。	
Bette	贝蒂	
Betty	蒂希伯砩系凼鞘募s。	
Betty	贝蒂
Beulah	比尤R希伯硪呀Y婚的。	
Beverly	芙英	
Billy	比利	
Bill	比尔	
Blake	布莱克	
Blanche	布m琪lDo暇的；白N人的；白皙美的。	
Blanche	布兰奇	
Bobby	鲍比	
Bob	鲍伯	
Bonnie	邦妮拉丁甜美、漂亮、雅而善良的人。	
Bonnie	邦妮	
Brad	布拉德	
Brandon	布兰登	
Brant	布兰特	
Breenda	布{_w挑苷撸Γ缓隗	
Brenda	布伦达
Brent	布伦特	
Brian/Bryan	布赖恩	
Brianna	布莱安娜	
Bridget	布姬特w或m眩力量	
Britney	布兰妮	
Brittany	布列塔尼	
Brook	布克英傍溪而居之人。	
Brown	布朗	
Bruce	布鲁斯	
Caleb	迦勒	
Cameron	卡梅伦	
Camille	卡蜜拉拉丁好品性的高F女子。	
Camille	卡米尔	
Candance	坎蒂z拉丁崆椋坦#092;，的。	
Candice	坎蒂z拉丁崆椋坦#092;，的。	
Candice	莰蒂丝	
Candy	坎蒂	
Cara	卡拉x大利朋友；H鄣娜恕	
Carina	卡瑞娜	
Carlos	卡洛斯	
Carl	卡尔	
Carmen	卡门	
Carol	卡}法g唱，耳g快的歌	
Caroline	卡洛琳lD勇、健和训摹	
Caroline	卡罗琳	
Carol	凯罗尔	
Carrie	凯莉
Carry	凯丽	
Cary	凯里	
Caspar	卡斯帕	
Cassandra	卡桑德拉	
Cassie	凯西
Catherine	P瑟琳希D的人。	
Catherine	凯瑟琳
Cathy	Pz希D的人。	
Cathy	凯茜
Cecilia	塞西莉拉丁力朦V的人，失明的。	
Cecil	塞西	
Celeste	莎莉z特拉丁最幸福的人，天的。	
Charlene	沙琳
Charles	查尔斯	
Charlotte	夏洛特法身w健女性化的。	
Charlotte	夏洛特	
Chelsea	切尔西	
Cheney	采尼	
Cherry	_莉法仁慈，像烟野慵t的人。	
Cherry	切莉	
Cheryl	_悍珍鄣娜耍男子h	
Cheryl	雪莉尔
Chloe	克洛怡希D青春的，美的。	
Chloe	克洛伊	
Christian	克里斯蒂安	
Christina	克里斯蒂娜
Christine	克莉z汀希D基督的追S者，T徒。	
Christine	克里斯汀	
Christopher	克里斯多夫	
Christy	克里斯蒂
Chris	克莉丝
Chris	克里斯
Cindy	辛迪
Claire	克R豪丁N的；明亮的；明的。	
Claire/Clair	克莱尔	
Clara	克R拉拉丁明亮的；明的。	
Clark	克拉克	
Claudia	克劳迪娅	
Clementine	克R曼婷拉丁厝崆胰蚀鹊娜恕	
Clement	克莱门特	
Cliff	柯利弗	
Cloris	克劳瑞丝	
Cody	科迪	
Cole	科尔	
Colin	科林	
Connie	康妮
Constance	康斯坦z拉丁远ㄖ的人。	
Constance	康斯坦斯	
Cora	柯拉希D女；少女。	
Coral	卡洛合ＥD，法珊瑚或品，彩石。	
Cora	科拉	
Cornelia	可妮莉雅希D山茱萸洌角。	
Corrine	科瑞恩	
Cosmo	科兹莫	
Crystal	克莉斯多希D晶的冰，透明的`魂，]有欺m。	
Crystal	科瑞斯特尔
Cynthia	辛西希D月亮女神黛安娜的Q。	
Daisy	黛西英r菊。	
Daisy	戴茜	
Dale	黛河居住在丘陵g之山谷中者。	
Dana	黛娜希伯碜缘的人；神的母H；明且的。	
Daniel	丹尼尔	
Daphne	黛芙妮希D神月桂洌还鸸凇	
Daphne	达芙妮	
Darcy	达茜	
Darlene	_娜英厝峥郏惑wN地	
Darwin	达尔文	
Dave	戴夫
David	大卫	
Dawn	潼恩英黎明，拘眩振作。	
Debbie	黛比
Debby	黛碧希伯砻鄯洌环渫酢	
Deborah	黛博拉希伯砻鄯洌环渫酢	
Deborah	黛博拉	
Debra	黛布拉	
Deirdre	迪得莉wn愁的。	
Delia	迪雅希D牧羊女	
Demi	黛米	
Denise	丹尼z希D代表花。	
Dennis	丹尼斯	
Denny	丹尼	
Derek	德里克	
Diana	黛安娜拉丁光亮如白；月亮女神	
Diana	黛安娜	
Dick	狄克	
Dinah	黛娜希伯肀辉u判的人，雅各的女骸	
Dolores	多洛莉z拉丁悲，痛苦或z憾。	
Dolores	德洛丽丝	
Dominic	多明尼卡拉丁凫渡系鄣摹	
Donald	唐纳德	
Donna	唐娜拉丁FD，淑女，夫人。	
Donna	堂娜	
Dora	多拉希D神的Y。	
Dora	多拉	
Doreen	多琳希D神的Y。	
Doris	多莉z希D碜源蠛５模缓Ｑ笈神。	
Doris	桃瑞丝	
Dorothy	桃匪瓜ＥD上帝的Y。	
Douglas	道格拉斯	
Duke	杜克	
Dylan	迪伦	
Eartha	莎英土地或泥土；比喻像大地般匀痰娜恕	
Eddie	埃迪	
Eden	伊甸希伯砺}中的@，g分地。	
Edgar	埃德加	
Edison	爱迪生	
Edith	伊蒂z古英格Y；。	
Editha	伊迪萨	
Edith	伊迪丝	
Edmund	艾德蒙	
Edward	爱德华	
Edwina	艾德文娜英有r值的朋友；a的@得者。	
Edwin	艾德文	
Eileen	哿丈w光亮的，人喜g的。	
Elaine	伊恩法光亮的；年幼的小鹿。	
Elaine	伊莱恩	
Eleanore	艾琳Z法光亮的；多a的，肥沃的，有收的。	
Eleanor	埃莉诺	
Elijah	以利亚	
Elizabeth	伊莉莎白希伯砩系鄣氖募s。	
Elizabeth	伊丽莎白	
Ella	艾拉lD火炬	
Ella	埃拉	
Ellen	艾希D、拉丁火把	
Ellen	爱伦	
Ellie	艾莉
Elliott	艾略特	
Elma	艾希D富坌牡娜耍H切的。	
Elsa	莎希D#092;的。	
Elsa	埃尔莎
Elsie	艾西希伯恚希D上帝的誓s，#092;的。	
Elva	艾娃斯堪的那S神奇且聪明的。	
Elvira	艾薇拉拉丁小精`，白N人的。	
Elvis	埃尔维斯	
Emerald	艾米瑞达	
Emily	艾蜜莉lD，拉丁勤勉^l的；有一口亮A的嗓音之人；拍R屁的人。	
Emily	艾米丽	
Emma	艾lD祖先。	
Emma	艾玛	
Enid	伊妮德塞特人得毫o瑕恪	
Enid	伊妮德	
Enterprise	企业英语培训	
Erica	艾卡lD有嗔Φ模坏弁醯模唤y治者。	
Erica	埃莉卡
Eric	埃里克
Erin	艾琳w在海中是的翡翠；和平，安之源。	
Estelle	爱斯特尔	
Esther	艾z特希伯硇切	
Esther	爱丝特	
Ethan	伊桑	
Ethel	艾瑟河尊F的；出身高F的。	
Eudora	尤朵拉希D可鄣馁Y，美好的、愉快的。	
Eudora	尤杜拉	
Eugene	柳真	
Eunice	尤妮z希D快返倮。	
Evangeline	伊文捷琳希D福音的信差，福音；天使	
Evan	埃文	
Eva	伊娃	
Eve	伊芙希伯砩命；x予生命者生`之母	
Evelyn	伊芙琳塞特生命；易相的人；令人愉快的人。	
Evelyn	伊夫林	
Eve	伊芙	
Faithe	M滋拉丁忠可信的人。	
Fannie	芬妮
Fanny	梵妮法自由之人。	
Fay	M怡法忠或忠#092;；小仙女。	
Fay	费怡	
Fiona	菲奥纳	
Flora	弗_拉拉丁花；花之神	
Flora	福罗拉	
Florence	弗_z塞特_花的或美的。	
Florence	弗罗伦丝	
Flta	上海英语外教	
Ford	福特	
Frances	法m西斯法自由之人，o拘束的人。	
Frances	弗郎西丝
Francis	弗兰克思	
Franklin	富兰克林	
Frank	弗兰克
Freda	弗莉_德和平；Iд摺	
Frederica	菲蕾德翠卡lD和平的Iд摺	
Frederica	弗雷德里卡	
Fred	弗瑞德	
Frieda	弗里达	
Gabrielle	嘉比里拉希伯砩系劬褪橇α俊	
Gabriel	加百利	
Gaby	加比
Gail	w英快返模怀歌；{谷	
Garfield	加菲尔德	
Gary	加里	
Gavin	加文	
Gemma	姬x大利石	
Genevieve	珍妮芙古威斯金碧眼的人；白N人。	
Geoffrey	杰弗里	
George	乔治	
Georgia	讨希Dr夫。	
Geraldine	衫汀德而有力的L矛。	
Gill	姬豪丁少女。	
Gillian	吉莉安
Gina	吉娜
Gino	基诺	
Giselle	吉榭lD一把	
Gladys	葛R蒂z威斯公主。	
Gladys	格拉蒂丝
Glendon	格林顿	
Glen	格林	
Gloria	葛_瑞拉丁s耀者，光s者。	
Gloria	格罗瑞娅	
Grace	葛瑞z英，法，拉丁雅的。	
Grace	格瑞丝	
Greta	格瑞塔
Griselda	葛莉x_德指φ煞O暮腿棠偷呐人。	
Gustave	葛佳z塔芙德，瑞典。	
Gwendolyn	P德琳塞特白色眉毛的。	
Gwendolyn	格温多琳	
Haley	海莉	
Hank	汉克	
Hannah	h娜希伯雅的。	
Hannah	汉娜	
Hardy	哈帝	
Harriet	哈莉特法家庭主D	
Harrison	哈里森	
Harry	哈利	
Hayden	海顿	
Hazel	海柔英I袖，指]官。	
Heather	赫瑟英_花的石楠。	
Hebe	赫柏	
Hedda	赫_德Y或痿Y。	
Hedy	赫蒂希D甜蜜，又令人欣p的。	
Heidi	海蒂
Helen	海希D，拉丁火把；光亮的。	
Helena	海伦娜	
Hellen	海伦
Heloise	海洛伊z法健全的；在錾虾艹雒。	
Henna	汉纳	
Henry	亨利	
Hermosa	何蒙莎西班牙美。	
Hilary	希拉瑞莉拉丁快返摹	
Hilda	希_lD痿Y；女鹗	
Hillary	希拉里/希拉蕊/希拉莉	
Hilton	希尔顿	
Honey	h妮英H鄣娜恕	
Howard	霍华德	
Hugo	雨果	
Hulda	胡_lD雅，被大深深喜鄣摹	
Hunk	汉克	
Ian	伊恩	
Ida	艾_德快返模勤^的，富有的	
Ignativs	伊格纳缇伍兹
Ina	艾娜拉丁母H。	
Ingrid	英格斯堪的那S女海豢鄣娜恕	
Ingrid	英格丽德	
Irene	艾琳法，拉丁和平；和平女神。	
Irene	艾琳	
Iris	劾蚪z拉丁彩虹女神；S尾花。	
Iris	艾丽丝	
Irma	艾拉丁，lD地位很高的；高F的	
Isaac	艾萨克	
Isabel	伊莎蓓希伯砩系鄣氖募s。	
Isabella	伊莎贝拉	
Isaiah	以赛亚/艾塞亚	
Ishara	爱沙拉	
Ivan	伊凡	
Ivy	艾薇希D希D髡f中的神}食物。	
Ivy	艾维	
Jackson	杰克逊	
Jack	杰克	
Jacob	雅各布	
Jacqueline	Z桂琳法上帝保o。	
Jacqueline	杰奎琳	
Jade	小玉	
James	詹姆士
Jamie	婕咪拉丁取而代之者。	
Jamie	詹米
Jane	珍希伯恚法上帝是慈悲的；少女。	
Janet	珍妮特希伯恚法少女，上帝的恩n	
Janet	珍妮特
Jane	简
Janice	珍尼z希伯恚法少女；上帝是仁慈的。	
Jasmine	贾斯敏	
Jason	詹森	
Jay	杰伊	
Jean	琴法上帝是慈悲的。	
Jean	姬恩
Jeffery	杰弗瑞	
Jenna	珍娜	
Jennifer	珍尼佛英白色的波；施魔法，妖G，迷人的女人。	
Jennifer	詹妮弗	
Jenny	珍妮希伯恚法少女。	
Jenny	詹妮
Jerome	杰罗姆	
Jerry	杰瑞
Jesse	杰西	
Jessica	芪骷蜗２砩系鄣亩；富。	
Jessica	杰西卡
Jessie	婕西希伯砩系鄣亩；富。	
Jessie	杰西
Jill	姬荷裨少女；偃恕	
Jill	姬尔
Jimmy	吉米
Jim	吉姆
Jo	烫K格m偃恕	
Joa	法，神上帝仁慈的Y。	
Joanna	贪材认２砩系廴蚀鹊馁Y。	
Joanna	乔安娜	
Joanne	希伯硐２砩系廴蚀鹊馁Y。	
Joan	琼
Jocelyn	Z思琳拉丁愉快的；快返	
Jocelyn	乔斯林	
Jodie	痰傧２矸浅Ｎ撵o；美。	
Joe	乔
Johnny	约翰尼
John	约翰	
Joliet	乔莉埃特	
Jonathan	乔纳森	
Jordan	乔丹	
Jose/Joseph	约瑟夫	
Josephine	s瑟芬希伯碓；多a的女子。	
Josephine	约瑟芬	
Joshua	约书亚	
Josie	乔茜
Joy	桃晾丁欣喜；快	
Joyce	桃两z拉丁快返模g返摹	
Joyce	乔伊斯
Joy	乔伊	
Judith	朱蒂斯希伯碜美；文o之女	
Judith	朱迪丝	
Judy	朱蒂希伯碜美。	
Judy	朱蒂
Julia	朱拉丁^柔的；年p。	
Juliana	朱莉安娜	
Julia	朱莉娅	
Julie	朱莉希D有柔和平o的。	
Juliet	朱~拉丁^柔的；年p的。	
Julie	朱莉	
June	朱恩拉丁六月。	
June	朱恩	
Justin	贾斯汀	
Kama	卡印度壑神。	
Karen	P希D。	
Karen	凯琳
Karida	卡瑞达	
Kate	凯特
Katherine	P瑟琳希D的。	
Katherine	凯瑟琳
Kathy	凯西
Katie/Kate/Katy	卡蒂	
Katrina	卡特里娜	
Kay	P伊英欣喜的；瑟王之兄弟。	
Kayla	凯拉	
Kay	凯
Keith	凯斯	
Kelly	P莉w女鹗俊	
Kelly	凯莉	
Kelsey	凯尔西	
Kennedy	肯尼迪	
Kenneth	肯尼斯	
Kenny	肯尼
Ken	肯
Kevin	凯文	
Kimberley	金百莉英出生皇家草地上的人。	
Kimberly	特里娜	
Kitty	吉蒂希D的。	
Kitty	基蒂
Kristin	克莉z汀希D基督的追S者、T徒。	
Kyle	凯尔	
Lance	兰斯	
Lareina	莱瑞拉	
Larry	拉里
Lassie	蕾西	
Laura	_拉拉丁月桂洌倮。	
Laura	劳拉
Laurel	_瑞拉丁月桂洌倮。	
Lauren	_拉丁月桂洹	
Laurent	劳伦特	
Lauren	罗兰/劳伦	
Lawrence	劳伦斯	
Leander	利安德尔	
Lee	李英草地的居民；庇o所。	
Lee	李	
Leila	莉拉阿拉伯黑的美女子；夜晚出生的。	
Lena	莉娜拉丁寄宿；寓所。	
Lena	莉娜
Leona	李W娜拉丁{。	
Leonard	雷纳德	
Leopold	利奥波特	
Leo	雷欧
Lesley	雷思w碜岳系谋荆欢青@。	
Leslie	莱斯利	
Letitia	列蒂西雅拉丁，西班牙快返模恍老驳摹	
Lilith	李莉斯希伯凫锻砩系摹	
Lillian	希D一朵百合花，代表；上帝的誓s。	
Lillian	莉莲
Lily	莉莉	
Linda	琳_西班牙美的人。	
Linda	琳达	
Lindsay	琳lD碜院＿的菩提洹	
lindsay	琳赛	
Lisa	莎希伯ι穹瞰I。	
Lisa	丽莎
Liz	莉斯希伯砩系劬褪鞘募s。	
Liz	莉兹
Lora/Laura	洛拉	
Loren	劳伦
Lorin	劳瑞恩	
Lori	劳瑞
Lorraine	洛法碜苑洛林小的人。	
Lorraine	罗琳	
Louisa	路易莎	
Louise	璐易zlD闻名的鹗	
Louise	路易丝	
Louis	路易斯	
Lucia	露西娅	
Lucine	露西妮	
Lucy	露西拉丁砉饷骱痛厦鞯娜恕	
Lucy	露茜	
Luke	卢克/路加	
Lulu	露露
Lydia	莉蒂英碜岳锏的人，富。	
Lydia	莉迪娅	
Lydia	莉迪娅/莉蒂亚	
Lynn	琳英傍湖而居的人	
Lynn	林恩	
Mabel	梅布尔/玛佩尔	
Madeline	马德琳	
Maggie	玛姬
Mamie	玛米
Manda	曼达	
Mandy	曼迪
Marcus	马库斯	
Marcy	马西	
Margaret	玛格丽特	
Mariah	玛丽亚
Marilyn	玛里琳/玛丽莲/玛丽琳	
Marks	马科斯	
Mark	马克	
Marshal	马歇尔	
Mars	马尔斯	
Martha	玛莎	
Martin	马丁	
Marvin	马文	
Mary	玛丽	
Mason	梅森	
Matilda	玛蒂尔达	
Matthew	马修	
Maureen	莫琳	
Mavis	梅维丝	
Maxine	玛克辛	
Max	马克斯	
Mayme	梅米	
May	梅	
Megan	梅甘	
Melinda	梅琳达	
Melissa	梅利莎	
Melody	美洛蒂	
Mercedes	默西迪丝	
Meredith	梅瑞狄斯	
Mia	米娅	
Michael	迈克尔	
Michelle	米歇尔
Mickey	米奇	
Mike	麦克	
Milly	米莉
Miranda	米兰达	
Miriam	米里亚姆	
Miya	米娅	
Molly	茉莉	
Monica	莫尼卡	
Morgan	摩尔根/摩根	
Nancy	南茜
Natalie	娜塔莉	
Natasha	娜塔莎
Nathaniel		
Nathan	纳撒尼尔	
Neil	尼尔	
Nelson	尼尔森	
Nicholas	尼古拉斯	
Nick	尼克	
Nicole	妮可	
Nikita	尼基塔	
Nina	尼娜
Noah	诺亚	
Nora	娜拉/诺拉	
Norman	诺曼	
Norma	诺玛	
Nydia	尼迪亚	
Octavia	奥克塔维亚	
Olina	奥琳娜	
Oliver	奥利弗	
Olivia	奥利维亚	
Ophelia	奥菲莉娅	
Oprah	奥帕
Oscar	奥斯卡	
Owen	欧文	
Pamela	帕梅拉	
Patricia	帕特丽夏	
Patrick	帕特里克/派翠克	
Patty	芭迪
Paula	保拉	
Pauline	波琳
Paul	保罗	
Pearl	珀尔	
Peggy	帕姬
Peter	彼得	
Philip	菲利普	
Philomena	菲洛米娜	
Phoebe	菲比	
Phyllis	菲丽丝	
Polly	波莉	
Priscilla	普里西拉	
Quentina	昆蒂娜
Quentin	昆廷	
Rachel	雷切尔	
Randall	兰德尔
Randolph	伦道夫	
Randy	兰迪
Raymond		
Ray	雷	
Rebecca	丽贝卡	
Reed	列得	
Regina	瑞加娜	
Rex	雷克斯	
Richard	理查德	
Richie	里奇
Riley	赖利/瑞利	
Rita	丽塔
Robert	罗伯特	
Robinson	罗宾逊/鲁宾逊	
Robin	罗宾
Rock	洛克	
Roger	罗杰	
Ronald	罗纳	
Ronald	罗纳德	
Rose	罗丝	
Rowan	罗文	
Roxanne	洛克萨妮	
Roy	罗伊	
Ruth	露丝	
Ryan	赖安	
Sabrina	萨布丽娜	
Sally	萨莉	
Samantha	萨曼莎	
Sami	萨米	
Sammy	萨米
Samuel	塞缪尔	
Sam	萨姆/山姆
Sandra	桑德拉	
Sandra	桑德拉
Sandy	桑迪
Sarah/Sara	莎拉	
Savannah	萨瓦纳/萨瓦娜	
Scarlett	斯佳丽/斯嘉丽	
Scott	斯考特	
Sean	肖恩
Selina	塞琳娜	
Selma	塞尔玛	
Serena	塞丽娜	
Sharon	莎伦
Shawn	肖恩
Sheila	希拉	
Shelley/Shelly	雪莉
Sherry	雪丽
Shirley	雪莉	
Sidney	西德尼	
Sierra	斯莱瑞	
Silvia	西尔维亚	
Simon	西蒙	
Solomon	所罗门	
Sonia	索尼亚	
Sophia	索菲娅	
Spark	斯帕克	
Spencer	斯宾塞	
Spike	斯派克	
Stacy	丝塔茜
Stanley	斯坦利	
Stella	丝特拉
Stephanie	斯蒂芬妮	
Steven	史蒂文
Steve	史蒂夫	
Stewart	斯图尔特	
Stuart	斯图亚特	
Sue	苏
Sunny	萨妮
Susan	苏珊	
Tamara	塔玛拉	
Tammy	苔米
Tanya/	谭雅坦尼娅
Tasha	塔莎	
Ted	泰德	
Terence	特伦斯	
Teresa	特莉萨	
Terry	特里
Tess	苔丝
Thomas	托马斯	
Tiffany	蒂凡妮	
Timothy	蒂莫西	
Tim	提姆	
Tina	蒂娜	
Todd	托德	
Tommy	汤米
Tom	汤姆
Tonya	棠雅/东妮亚	
Tony	托尼
Tracy	特蕾西	
Tyler	泰勒	
Ultraman	奥特曼	
Ulysses	尤利塞斯	
Ursula	厄休拉	
Vanessa	温妮莎	
Van	范	
Venus	维纳斯	
Vera	维拉	
Vernon	弗农	
Vern	弗恩
Vicky	维姬
Victoria	维多利亚	
Victor	维克多	
Vincent	文森特	
Violet	维尔莉特	
Virginia	维吉妮亚	
Vita	维达	
Vivian	薇薇安	
Wanda	旺达	
Warner	华纳	
Warren	沃伦	
Wayne	韦恩	
Wendy	温蒂
Wesley	卫斯理	
Whitney	惠特尼	
William	威廉	
Willy	威利/维利	
Winnie	温妮	
Wynne	韦恩	
Yolanda	尤兰达	
Yvette	伊薇特
Yvonne	伊温妮	
Zachary	圣扎迦利	
Zack	扎克	
Zara	莎拉	
Zelda	塞尔达	
Zoey/Zoe	佐伊	
Zora	卓拉	
